GEOID,DISTRICT
370010205012023,6
370010205012019,6
370010205012038,6
370179501002090,7
370179501002084,7
370179501002100,7
370250424011031,8
370250412001027,8
370250407031003,8
